11,11,Finish!,Level3.txt
x,x,x,x,x,x,x,x,x,x,x
x,c,c,c,c,c,c,c,c,c,x
x,c,c,c,c,c,c,c,c,c,x
x,c,c,x,x,x,x,x,c,c,x
x,c,c,x,o,o,o,x,c,c,x
x,c,c,x,o,C,o,x,c,c,x
x,c,c,x,o,o,o,x,c,c,x
x,c,c,x,x,x,x,x,c,c,x
x,c,c,c,c,c,c,c,c,c,x
x,c,c,c,c,c,c,c,c,c,x
x,x,x,x,x,x,x,x,x,x,x